《The British Grenadiers》	 Various Artists
《Всё выше》	 俄罗斯军乐团
《В путь》	 俄罗斯军乐团
《Traditional: Auld Lang Syne》	 Royal Scots Dragoon Guards
《Tu Vuo' Fa' L'americano》	 Quadro Nuevo
《嘟滴嘟滴当当》	 YinTianXiang
《Sing for Me (Lohse Version)》	 Borislav Slavov
《Theme of Seliana》	 成田暁彦
《Main Theme - Stars At Our Backs》	 牧野忠義
《猫咪物语》	 于行; 仁辰
《Афган》	 Валерий Петряев
《Auld Lang Syne》	 Charlie Landsborough
《Mon piano d'amour》	 Angel Lover
《Shag Nasty (Original Version)》	 Ol' Desmond
《Batty McFaddin》	 Kevin MacLeod
《Once again (feat. Abu Jakaria) (Abu Jakaria Remix)》	 Abu Jakaria
《Requiem For A Dream》	 Jennifer Thomas
《One Step Closer》	 Jeick Walker
《At The Uncharted Harmony (Original Version)》	 Jazzman Georgie
《Deadman's Gun》	 Christian Larsson
《La Java Va Bien》	 French Accordion
《Aunt Tagonist》	 Kevin MacLeod
《The People United Will Never Be Defeated: Thema. Tempo I》	 Ursula Oppens
《Memory Forgotten》	 Must Save Jane!
《God's Gonna Cut You Down》	 Johnny Cash
《葡萄物语》	 于行; 仁辰
《草莓物语》	 于行; 仁辰
《TIRED OF PROBLEMS》	 Just loving it yes
《Sea of Tranquility》	 BeMax
《皇家萌卫》	 灵空音乐
《明年今日》	 陈奕迅
《Dancing》	 Ray-X
《Close Eyes》	 DVRST
《Happy People》	 In-spired Music
《Arabian Adventure(New Mix1)》	 Eugene Star
《吻别》	 张学友
《十年》	 陈奕迅
《Valhalla Calling》	 Miracle Of Sound
《おもちゃのチャチャチャ》	 村方乃々佳
《ねこふんじゃった》	 村方乃々佳
《Eh eh aye I’m on vacation》	 Yuvin
《牵着蜗牛去散步》	 张辉
《轻松快乐又动感》	 自清欢
《所念皆星河》	 CMJ
《勇气大爆发》	 童童只会嘤嘤
《小熊饼干（纯音乐）》	 BLACKDD
《吨吨吨吨吨 嘿》	 苏小宝; 圈妹; 虞姬
《蜜桃物语》	 仁辰; 于行
《开心快乐轻松~》	 欧阳曼曼
《暮色回响》	 张韶涵
《Way Down We Go》	 KALEO
《V》	 Marcin Przybyłowicz
《We Shall Sail Together (Original Game Soundtrack) [Instrumental]》	 Sea of Thieves
《Bosun Bill》	 Sea of Thieves
《We Shall Sail Together (Original Game Soundtrack)》	 Sea of Thieves
《The Rebel Path》	 P.T. Adamczyk
《I Really Want to Stay At Your House》	 Rosa Walton; Hallie Coggins
《国际歌》	 中央乐团合唱队
《Интернационал》	 Оркестр Государственного академического Большого театра СССР; Геннадий Рождественский; Хор Государственного академического Большого театра СССР
《国际歌》	 唐朝乐队
《无地自容》	 黑豹乐队
《Saxaboom》	 Max Govor
《Die Internationale (Live)》	 Hannes Wader
《The River》	 Blues Saraceno
《荷塘月色》	 凤凰传奇
《奢香夫人》	 凤凰传奇
《Doin’ Dirt》	 Maroon 5
《Roly Poly》	 T-ara
《Sweet Dreams (Are Made Of This)》	 Eurythmics
《Popipo》	 初音ミク; blastxtrap
《Xenogenesis》	 TheFatRat
《FANTASTIC BABY》	 BIGBANG
《爱情转移》	 陈奕迅
《无名的人 (live)》	 孙楠; 陈楚生
《人间道》	 刘欢
《无名的人》	 毛不易
《元首の小曲 // Erika // 艾丽卡》	 ShintoKosei
《大笑江湖》	 小沈阳; 贾振峰; 郭梓
《月半小夜曲 (Live)》	 李克勤; 周深
《千千阙歌 (Live)》	 周深
《匆匆那年》	 周深
《玫瑰少年 (Live)》	 周深; GAI周延
《化身孤岛的鲸》	 周深
《El Pueblo Unido Jamás Será Vencido (En Vivo)》	 Quilapayun; Inti Illimani Historico
《东北的冬》	 小沈阳
《起风了》	 周深
《灯火里的中国 (舒楠监制 官方正式版)》	 张也; 周深
《听 (live)》	 谭维维; 周深
《America; **** Yeah (Album Version)》	 Team America
《それが大事》	 大事MANブラザーズバンド
《Ghost Riders In The Sky》	 Christian Larsson
《Ghost Riders In The Sky (Memories Of The Old West Album Version)》	 Craig Duncan
《I Wanna Be In The Cavalry (Reprise)》	 Seth Staton Watkins
《Wellerman Sea Shanty (feat. NATHAN EVANS) (Funkified Version)》	 GR3ED; Nathan Evans
《All For Love (Sped Up)》	 Daciva
《Lone Ranger》	 ___TEMPOCONTROL
《The Last Shanty》	 Nathan Evans
《Skull and Bones》	 Home Free
《POP SONG》	 米津玄師
《Palladio》	 Escala
《Wellerman》	 The Wellermen
《匈牙利圆舞曲》	 Johannes Brahms
《So Far Away (Acoustic)》	 Adam Christopher
《Катюша》	 Варвара
《Wohlan Die Zeit Ist 'Kommen》	 Soldatenchor; Lübecker Polizeiorchester
《めざせポケモンマスター》	 松本梨香
《ドラえもんのうた》	 大杉久美子
《Way Back Home》	 SHAUN
《亮剑》	 北京室内男声合唱团; 柏菲音乐
《再见》	 张震岳
《同桌的你》	 老狼
《Es war ein Edelweiß》	 Musikkorps der 1. Gebirgsdivision Garmisch-Partenkirchen
《阳光开朗大男孩》	 卦者灵风
《Come and Get Your Love》	 Redbone
《Hiding In The Blue》	 TheFatRat; RIELL
《I Wanna Be In The Cavalry》	 Seth Staton Watkins
《RAVE》	 Dxrk ダーク
《ブルーバード》	 いきものがかり
《Sat Tee Touy》	 Neung Phak
《Murder In My Mind》	 Kordhell
《Memory Reboot》	 VØJ; Narvent
《Wake (Live)》	 Hillsong Young & Free
《NIGHT DANCER》	 imase
《Bones》	 Imagine Dragons
《If We Ever Broke Up》	 Mae Stephens
《TIRED OF PROBLEMS》	 NUEKI; TOLCHONOV; Glichery
《The Housebuilding Song》	 David Ferguson
《Erika - German marching song》	 shirts0001
《Die Wacht am Rhein》	 Deutsche Musik
《Way Down We Go》	 KALEO
《执迷》	 曲悠
《Faded异域 (变速0.9x)》	 DJ铁柱
《艾斯琳·索尔海姆-Faded异域（JacLa Remix）》	 JacLa
《青花》	 周传雄
《爱你》	 王心凌
《董小姐》	 宋冬野
《安和桥》	 宋冬野
《悬溺》	 葛东琪
《盛夏》	 毛不易
《一程山路》	 毛不易
《匆匆那年 (Live)》	 古巨基
《We Don't Talk Anymore》	 Charlie Puth; Selena Gomez
《PonPon Shit》	 ナマコプリ; Us Cracks
《安和曲》	 吉日嘎拉
《Aloha Heja He》	 Achim Reichel
《The Boy I Used To Know》	 Marie Serneholt
《The Spectre》	 Alan Walker
《One More Night》	 Maroon 5
《向云端》	 小霞; 海洋Bo
《Raindrops (Intl. Version)》	 Katja Krasavice; Leony
《golden hour》	 Strictlyviolin荀博; 马克Musician
《golden hour》	 JVKE
《若把你》	 Kirsty刘瑾睿
《凄美地》	 郭顶
《Smooth Criminal》	 Michael Jackson
《自由飞翔(交响乐版)》	 中国爱乐乐团
《荷塘月色(交响乐版)》	 中国爱乐乐团
《最炫民族风(交响乐版)》	 中国爱乐乐团
《策马奔腾(交响乐版)》	 中国爱乐乐团
《我和草原有个约定(交响乐版)》	 中国爱乐乐团
《一代天骄(交响乐版)》	 中国爱乐乐团
《中国味道(交响乐版)》	 中国爱乐乐团
《沙漠之恋(交响乐版)》	 中国爱乐乐团
《吉祥如意(交响乐版)》	 中国爱乐乐团
《醉美天下(交响乐版)》	 中国爱乐乐团
《月亮之上(交响乐版)》	 中国爱乐乐团
《爱我中华》	 宋祖英
《水中花》	 郁可唯
《笼》	 张碧晨
《Lose Control》	 Hedley
《水手》	 郑智化
《極楽浄土》	 GARNiDELiA
《Billie Jean》	 Michael Jackson
《Wolf Totem》	 The Hu
《处处吻》	 杨千嬅
《生日祝福歌》	 格格
《国色天香•对唱版》	 李玉刚; 孔东东
《清明上河图》	 李玉刚
《California Gurls》	 Katy Perry; Snoop Dogg
《鼓楼》	 赵雷
《我记得》	 赵雷
《걱정말아요 그대》	 全仁权
《不潮不用花钱》	 林俊杰
《我的祖国》	 郭兰英
《我和我的祖国》	 王菲
《在那遥远的地方 (青海民歌)》	 群星
《彩云追月 (广东民歌)》	 群星
《春江花月夜 (江南吴歌)》	 群星
《茉莉花》	 宋祖英
《秦淮景》	 吴亮莹
《囚鸟》	 张宇
《太空电梯》	 阿鲲
《щα泳てrч 僵GΓΑ∨∑＄（虽华 remix）》	 虽华
《Brainiac Maniac (Suihua Remix)》	 虽华
《Βг@!Nïaç ▲▲αN1aс（虽华 remix）》	 虽华
《Grãぜ τΗ∑ я∞∮（虽华 remix）》	 虽华
《Unstoppable》	 Sia
《Hotel California (Live on MTV; 1994)》	 Eagles
《说书人》	 暗杠; 寅子
《对面的女孩看过来》	 任贤齐
《当》	 动力火车; 马鑫; 付小墨; 伊西永藏
《雨蝶》	 李翊君
《夕焼けの歌》	 近藤真彦
《Please Don't Go》	 Joel Adams
《Hey Mamma (Radio Edit)》	 Sunstroke Project
《一剪梅 (DJ版)》	 69; 肖涵; 沈子凡
《Eminem-Clean Bandit Rather Be Without Me Full Version（9DIUZ remix）》	 9DIUZ
《Without Me》	 Eminem
《The Cup Of Life》	 Ricky Martin
《しんかいしょうじょ》	 初音ミク; ゆうゆ
《妄想感傷代償連盟》	 DECO*27; 初音ミク
《千本桜》	 黒うさP; 初音ミク
《my long forgotten cloistered sleep (unreleased work of Xenosaga)》	 Emily Bindiger
《Who's Ready for Tomorrow》	 RAT BOY; IBDY
《波基上校进行曲(口哨版)》	 群星
《西班牙斗牛士》	 欧翠峰
《Laxed (Siren Beat)》	 Jawsh 685
《Your Man》	 Josh Turner
《Yesterday Once More》	 Carpenters
《香蕉之歌》	 小黄人
《海のまにまに》	 YOASOBI
《おどるポンポコリン》	 B.B.クイーンズ
《おどるポンポコリン》	 大原櫻子
《大花轿》	 火风
《岁月神偷》	 金玟岐
《漠河舞厅·2022》	 柳爽
《Умри если меня не любишь》	 AnimeVibe
《新宝島》	 サカナクション
《别怕我伤心》	 悦开心i; 张家旺
《Dangerous》	 Michael Jackson
《La Copa de la Vida ( Spanish Version)》	 Ricky Martin
《это ли счастье?》	 Rauf & Faik
《Ievan Polkka》	 Korpiklaani
《我恨我痴心》	 刘德华
《China (The Atomic Era)》	 Geoff Knorr
《Sogno di Volare (“The Dream of Flight”)》	 Angel City Chorale; Christopher Tin
《Государственный гимн СССР》	 俄罗斯军队模范亚历山德罗夫红旗歌舞团
《Gee》	 少女时代
《爱江山更爱美人》	 阿虾
《Here's a Health to the Company》	 Sean Dagher; Richard Irwin; Nelson Carter; Nils Brown; Michiel Schrey; Charlotte Cumberbirch; David Gossage
《Randy Dandy Oh》	 Sean Dagher
《Star of the County Down》	 Sean Dagher; Richard Irwin; Nelson Carter; Nils Brown; Michiel Schrey; David Gossage
《Spanish Ladies》	 Charlotte Cumberbirch; Richard Irwin; Sean Dagher; Nelson Carter; David Gossage
《Drunken Sailor》	 Sean Dagher; Nils Brown; Michiel Schrey
《Over the Hills and Far Away》	 Michiel Schrey; Sean Dagher; Nils Brown; Charlotte Cumberbirch; Nelson Carter; Richard Irwin; David Gossage
《Lowlands Away》	 Nils Brown; Sean Dagher; Clayton Kennedy
《Leave Her Johnny》	 Sean Dagher
《Johnny Boy》	 Santiano
《三级警报BGM》	 V.A.
《二级警报BGM》	 V.A.
《日常BGM》	 V.A.
《一级警报BGM》	 V.A.
《Wellerman》	 Nathan Evans
《允许部分艺术家先富起来》	 二手玫瑰
《仙儿》	 二手玫瑰
《火车快开》	 二手玫瑰
《疯狂的外星人》	 二手玫瑰
《Auld Lang Syne》	 Home Free
《Try Everything》	 Home Free
《STONE OCEAN》	 ichigo
《Killer Queen》	 Queen
《男人海洋》	 周传雄
《Sea Shanty Medley》	 Home Free
《光字片》	 周深
《String Theocracy》	 Mili
《DJ haning-黑人抬棺（AKA小健 remix）》	 AKA小健（李健）
《Astronomia （黑人抬棺（唢呐版）》	 浑元Rysn
《Хоп》	 Azis
《人世间》	 雷佳
《热爱105°C的你（日文版）》	 白苒Shiro; 赤也也也子
《一笑懸命》	 遊助
《Stayin' Alive (From "Saturday Night Fever" Soundtrack)》	 Bee Gees
《Jump》	 Van Halen
《I Want You》	 Savage Garden
《RAGE OF DUST》	 SPYAIR
《MEGALOVANIA》	 Toby Fox
《Great Days Units Ver.》	 富永TOMMY弘明; Coda(小田和奏); 橋本仁; THE DU; batta; 青木カレン; 长谷川大祐
《Morsmordre》	 Crazy Donkey
《Something Just Like This》	 We Rabbitz; Adam Christopher; Guy Berryman; Chris Martin; Andrew Taggart
《膨胀》	 陆通
《Lemon》	 米津玄師
《牵丝戏》	 银临; Aki阿杰
《热爱105°C的你》	 腾格尔; 艾伦; 沈腾
《The Sun Also Rises》	 久石譲
《热爱105°C的你》	 阿肆
《桃林》	 武聆音雄
《名探偵コナン メイン・テーマ (から紅ヴァージョン)》	 大野克夫
《Enemy (from the series Arcane League of Legends)》	 Imagine Dragons; JID; 英雄联盟; 双城之战
《孤勇者》	 陈奕迅
《历代JOJO处刑曲》	 Daniel-Sousa
《Fighting Gold》	 Coda(小田和奏)
《ジョジョ その血の記憶～end of THE WORLD～》	 橋本仁; Coda(小田和奏); 富永TOMMY弘明
《漠河舞厅》	 柳爽
《喀秋莎【俄中日三语版】》	 张昕田; miri
《I Want It That Way》	 Jay Smith
《山川》	 李荣浩
《スターダストクルセイダース》	 菅野祐悟
《Jotaro's Theme (Trap Remix) (Trap Remix)》	 Kirara Magic Radio
《カチューシャ喀秋莎少女与战车版（翻自 プラウダ高校）》	 神楽七奈
《Hotel California (2013 Remaster)》	 Eagles
《Crazy Noisy Bizarre Town》	 THE DU
《Killer》	 菅野祐悟
《Awake》	 岩崎琢
《高潔なる教皇》	 菅野祐悟
《Great Days》	 青木カレン; 长谷川大祐
《canzoni preferite》	 长谷川大祐
《裏切り者のレクイエム》	 长谷川大祐
《STAND PROUD》	 橋本仁
《No Roots》	 Alice Merton
《Light That Fire》	 Oh The Larceny
《我的祖国》	 韩红
《美丽的神话》	 孙楠; 韩红
《九儿》	 韩红
《天路》	 韩红
《天亮了 (Live)》	 韩红
《마리오네트 (提线木偶)（翻自 Stellar）》	 你我的水宝; 柯雯; By道明寺_
《Casablanca》	 Bertie Higgins
《好想大声说爱你 (Live)》	 张杰
《直到世界尽头》	 张杰
《Beautiful In White (Demo)》	 Westlife
《将军叹》	 李玉刚
《王妃》	 萧敬腾
《Whatever It Takes》	 Imagine Dragons
《il vento d'oro》	 菅野祐悟
《错位时空》	 艾辰
《大唐Gang （prod by.Fantom）》	 倒悬的橘子; 唐僧; 孙悟空; 猪八戒; 沙僧
《无名之辈》	 陈雪燃
《喜欢你 (Live)》	 G.E.M.邓紫棋
《Seven Nation Army》	 Johan Soderqvist; Patrik Andrén
《Try》	 P!nk
《November Rain》	 Guns N' Roses
《Knockin' On Heaven's Door》	 Guns N' Roses
《当《喀秋莎》遇上《苏维埃进行曲》（翻自 丽基雅·鲁斯兰诺娃）》	 万伟康
《喀秋莎》	 中央乐团合唱队
《Подмосковные вечера》	 Владимир Трошин
《Рiчка》	 Юлія Рай
《ВДВ》	 Александр Буйков
《Ты неси меня река (Краса)》	 Lube
《За тебя; Родина-мать》	 Lube
《Гимн России》	 Lube
《花桥流水》	 纳兰珠儿; 高安
《I Hate Myself for Loving You》	 Joan Jett & the Blackhearts
《Havana》	 MADILYN
《钢铁洪流进行曲》	 李旭昊
《爸爸妈妈》	 李荣浩
《东北民谣》	 毛不易
《借》	 毛不易
《一回生二回熟（翻自 Justin Timberlake）》	 -Jason嘉-
《恋愛サーキュレーション》	 花澤香菜
《赤伶》	 李玉刚
《Turn Down for What》	 DJ Snake; Lil Jon
《下山》	 要不要买菜
《世间美好与你环环相扣》	 柏松
《Operation Barrenland (W&W Soundtrack Mix)》	 塞壬唱片-MSR; W&W
《THE RICK AND MORTY RAP (瑞克和莫蒂说唱音乐)》	 None Like Joshua; Gameboyjones
《Better Days - Giorni Migliori》	 OneRepublic; Negramaro
《stranger_think》	 C418
《Mark (Shahmen Remix)》	 Shahmen
《Its My Life》	 Село и люди
《年少有为》	 李荣浩
《We Are The World》	 Lionel Richie; Stevie Wonder; Paul Simon; Kenny Rogers; James Ingram; Tina Turner; Billy Joel; Michael Jackson; Diana Ross; Dionne Warwick; Willie Nelson; Al Jarreau; Bruce Springsteen; Kenny Loggins; Steve Perry; Daryl Hall; Huey Lewis; Cyndi Lauper; Kim Carnes; Bob Dylan; Ray Charles
《蝴蝶泉边》	 黄雅莉
《平凡的一天》	 毛不易
《消愁》	 毛不易
《像我这样的人》	 毛不易
《Astronomia》	 Vicetone; Tony Igy
《大哥你好吗》	 沈腾; 腾格尔
《buttercup》	 Jack Stauber
《Time Back》	 Bad Style
《可惜没如果》	 林俊杰
《Here With You》	 Asher Monroe
《Immortals》	 Fall Out Boy
《恋爱循环（唢呐版）》	 浑元Rysn
《Coincidance (抖肩舞)》	 Handsome Dancer
《Орлята; Ч. 1》	 Lube
《We Are Young (feat. Janelle Monáe)》	 Fun.; Janelle Monáe
《Soviet March》	 James Hannigan; The Skywalker Symphony Chorus
《我的梦 (Live)》	 张靓颖; 马臻
《Bad Liar – Stripped》	 Imagine Dragons
《Ready Aim Fire》	 Imagine Dragons
《Only Time》	 Enya
《Numb》	 Linkin Park
《What I've Done》	 Linkin Park
《Battle Symphony》	 Linkin Park
《In the End》	 Linkin Park
《Thunder / Young Dumb & Broke (Medley)》	 Imagine Dragons; Khalid
《走进新时代》	 群星
《你的答案》	 阿冗
《The Godfather (Love Theme)》	 Nino Rota
《Shotgun Senorita》	 Blue Stahli
《Der letzte Mohikaner》	 Leo Rojas
《需要人陪》	 王力宏
《Beat The Devil's Tattoo》	 Black Rebel Motorcycle Club
《起风了》	 吴青峰
《挪威的森林(Live)》	 伍佰 & China Blue
《突然的自我》	 伍佰 & China Blue
《Rescue Me》	 OneRepublic
《Connection》	 OneRepublic
《Start Again》	 OneRepublic; Logic
《Speed of Light》	 塞壬唱片-MSR; DJ Okawari; 二宮愛
《In the End》	 Tommee Profitt; Jung Youth; Fleurie
《Time Machine》	 Ingrid Michaelson
《Сука блядь》	 DJ Blyatman; Russian Village Boys
《RISE》	 英雄联盟; The Glitch Mob; Mako; The Word Alive
《Dance Monkey》	 Tones and I
《Where Did You Sleep Last Night (Live)》	 Nirvana
《In the Pines》	 Fantastic Negrito
《Machine》	 Imagine Dragons
《Boomerang》	 Imagine Dragons
《Monster》	 Imagine Dragons
《Birds》	 Imagine Dragons; Elisa
《It's Time》	 Imagine Dragons
《Whatever It Takes (Jorgen Odegard Remix)》	 Imagine Dragons; Jorgen Odegard
《Radioactive In The Dark》	 Fall Out Boy; Imagine Dragons
《Believer》	 Imagine Dragons; Lil Wayne
《Natural》	 Imagine Dragons
《Sold Out》	 Jonathan Steingard; Hawk Nelson
《钢铁洪流进行曲》	 艾深·乐生
《外婆桥》	 任然
《Furious Gods》	 Christopher Larkin
《Bad Romance》	 Jay Smith
《野狼disco》	 宝石Gem
《芒种》	 音阙诗听; 赵方婧
《Cancan》	 Jacques Offenbach
《Take Me Home Country Roads》	 John Denver
《中国功夫》	 屠洪刚
《童年 (Live)》	 罗大佑
《生僻字》	 陈柯宇
《逃亡 part2》	 塞壬唱片-MSR; BaoUner
《血液》	 塞壬唱片-MSR; BaoUner
《执棋者之骨》	 塞壬唱片-MSR; BaoUner
《泛用型自动化解决方案0.3.2.9f2》	 塞壬唱片-MSR; BaoUner
《短兵相接》	 塞壬唱片-MSR; BaoUner
《bad guy - with Justin Bieber》	 Billie Eilish; Justin Bieber
《曹操》	 林俊杰
《小酒窝》	 林俊杰; 蔡卓妍
《江南》	 林俊杰
《终局抵抗者》	 塞壬唱片-MSR; BaoUner
《精忠报国》	 屠洪刚
《男儿当自强》	 林子祥
《无与伦比的美丽》	 苏打绿
《Stayin' Alive》	 Bee Gees
《さくらのうた》	 高橋優
《ヤキモチ（吃醋）（翻自 高橋優）》	 麦菌
《言葉にできない想い》	 Aquaplus
《起风了》	 买辣椒也用券
《我妈已经三天没打我了》	 洛天依Official
《Young For You》	 GALA
《我相信》	 杨培安
《着魔》	 张杰
《夜空中最亮的星 (Live)》	 张杰
《逆战》	 张杰
《勿忘心安》	 张杰
《天下》	 张杰
《明天过后》	 张杰
《默 (Live)》	 张杰
《默》	 那英
《天堂》	 腾格尔
《Peer Gynt - Incidental Music: 4. Morning》	 Thomas Beecham; Royal Philharmonic Orchestra
《光辉岁月(国语)》	 Beyond
《我是愤怒》	 Beyond
《再见理想》	 Beyond
《华语流行乐进化史》	 Calculasian
《九州同》	 阿地力·阿不力孜; 缪青; 丁晓逵; 牛建党
《Time (Instrumental)》	 MKJ
《正月十五是元宵》	 泠鸢yousa
《Time（翻自 MKJ）》	 MKJ; TLV
《Not Today (The Building is On Fire)》	 The Gregory Brothers
《Not Today》	 Imagine Dragons
《九儿（Cover 谭晶）》	 AUZ
《Rags To Rings》	 英雄联盟; Mark Petrie; Danny McCarthy
《ROBOTICS;NOTES》	 林ゆうき
《Trailer - Definitive Edition》	 Gareth Coker; Aeralie Brighton
《天帷禁地领主：审判者马塞尔 - bloodhell boss》	 Dungeon and Fighter
《左手指月》	 萨顶顶
《Ezio's Family》	 Jesper Kyd
《沙漠骆驼》	 展展与罗罗
《烦恼歌》	 张学友
《Main Theme - Definitive Edition》	 Gareth Coker
《Believer》	 Imagine Dragons
《探清水河》	 晓月老板
《POP/STARS》	 K/DA; Madison Beer; (G)I-DLE; Jaira Burns
《金蛇狂舞 (中国传统民族音乐)》	 中国广播民族乐团
《茉莉花》	 洛天依Official
《Paradigm》	 Leslie Wai
《Red Horizon》	 Lost Years
《Nightpop feat. Zabutom》	 Dubmood; zabutom
《序列主义狂想症》	 4 Channels Club（肆通道倶楽部）
《葫芦娃（Gameboy Cover）》	 4 Channels Club（肆通道倶楽部）
《Last of the Wilds》	 Nightwish
《名探偵コナン メイン・テーマ(標的ヴァージョン)》	 大野克夫
《Белая армия; чёрный барон》	 俄罗斯军队模范亚历山德罗夫红旗歌舞团
《Красная Армия всех сильней（Cover 伊万诺夫·巴拉诺夫）》	 Lube
《Samsara》	 Tungevaag & Raaban
《Loonboon》	 Laura Shigihara
《Shots (Broiler Remix)》	 Imagine Dragons; Broiler
《I’m So Sorry》	 Imagine Dragons
《Прощание славянки》	 俄罗斯军乐团
《The Star Spangled Banner (Album Version)》	 Mormon Tabernacle Choir
《Take Me Home Country Roads》	 John Denver
《小星星》	 汪苏泷
《好日子》	 宋祖英
《好运来》	 祖海
《Happy Tree Friends》	 Ashsha Kin
《Deja Vu》	 Dave Rodgers
《Dreamcatcher》	 Bandari
《Moonglow》	 Bandari
《The Sounds Of Silence》	 Bandari
《Childhood Memory》	 Bandari
《Annie's Wonderland》	 Bandari
《Apologize》	 Timbaland; OneRepublic
《We Will Rock You》	 Queen
《I Want It That Way》	 Backstreet Boys
《All Rise》	 Blue
《My Love (Radio Edit)》	 Westlife
《Promise》	 山岡晃
《都是你》	 光良
《Time (Official)》	 MKJ
《For the Damaged Coda》	 Blonde Redhead
《단숨에》	 普天堡电子乐团
《Hit The Road Jack》	 Ray Charles
《为了遇见你》	 戚薇; 杨宗纬
《Mirror Night》	 V.K克
《Nightingale》	 Yanni
《The promise》	 Secret Garden
《Somewhere》	 July
《天之痕(钢琴版)》	 群星
《星空》	 Richard Clayderman
《鸟之诗》	 Pianoboy高至豪
《Take Me to Infinity (Radio Edit)》	 Consoul Trainin
《#Lov3 #Ngẫu Hứng》	 Hoaprox
《最好》	 薛之谦
《醉千年》	 李袁杰
《Intro》	 Oskord
《I Need a Doctor》	 Dr. Dre; Eminem; Skylar Grey
《Комбат》	 Lube
《Позови меня тихо по имени》	 Lube
《醉清风 (2005版)》	 弦子
《电台情歌》	 莫文蔚
《对不起;谢谢》	 陈奕迅
《醉拳》	 成龙
《Not A Sad Song》	 惟安娜Vienna
《Cries in a Distance》	 林俊杰
《HandClap》	 Fitz and The Tantrums
《А зори здесь тихие-тихие》	 Lube
《Давай за...》	 Lube
《约定(Live)》	 陈奕迅
《我们》	 陈奕迅
《阴天快乐》	 陈奕迅
《因为爱情》	 陈奕迅; 王菲
《于心有愧》	 陈奕迅
《稳稳的幸福》	 陈奕迅
《陪你度过漫长岁月》	 陈奕迅
《你给我听好》	 陈奕迅
《孤独患者》	 陈奕迅
《浮夸》	 陈奕迅
《前苏联国歌-牢不可破的联盟》	 俄罗斯军队模范亚历山德罗夫红旗歌舞团
《借我》	 谢春花
《往后余生》	 马良
《Come As You Are》	 Nirvana
《That Girl》	 Olly Murs
《时间胶囊》	 鋼兵
《千本樱(单独版)》	 鋼兵
《世界が终るまでは…》	 鋼兵
《自由の翼》	 鋼兵
《电磁炮 Only My Railgun》	 鋼兵
《Shape of You (中国风）》	 6＆9
《爱情怎么喊停》	 曾沛慈
《The Final Countdown》	 Europe
《说散就散》	 袁娅维TIA RAY
《Snowdreams》	 Bandari
《PLANET》	 ラムジ
《These Broken Hands Of Mine》	 Joe Brooks
《The Crisis》	 Ennio Morricone; Gilda Buttà; Accademia Musicale Italiana
《A Thousand Years》	 Christina Perri
《后来》	 刘若英
《Higher》	 The Score
《Miracle》	 The Score
《Unstoppable》	 The Score
《Better Than One》	 The Score
《Voices (Randy Orton) [feat. Rich Luzzi of Rev Theory]》	 Jim Johnston
《The Time Is Now (John Cena)》	 John Cena
《说散就散》	 艾福杰尼; 黄旭; 田羽生
《背对背拥抱》	 林俊杰
《蓝莲花》	 许巍
《都选C》	 大鹏
《不再犹豫 (Remix版)》	 大鹏; 黄贯中; 叶世荣
《My Everything》	 98º
《我们的时光》	 赵雷
《Soledad》	 Westlife
《花魁》	 徐良; 李玉刚
《To Be with You》	 Westlife
《Miss You》	 Westlife
《Let Her Go》	 Passenger
《You Are My Everything》	 Lexington Bridge
《Wish》	 S.E.N.S.
《When a Woman Loves a Man》	 Westlife
《Stay Here Forever》	 Jewel
《Sugar》	 Maroon 5
《Until You》	 Shayne Ward
《Restoring the Light; Facing the Dark》	 Gareth Coker
《有点甜》	 汪苏泷; By2
《12 Variations on Ah; Vous Dirai-Je; Maman; K. 265 Twinkle;》	 John Tesh
《Minuet in G》	 David Hoffman
《España Cani》	 André Rieu
《《夜色钢琴曲》kiss the rain（翻自 YIRUMA）》	 赵海洋
《不将就》	 李荣浩
《Beyond The Memory》	 July
《南诏宫廷 全长》	 月之门
《Over My Head (Better Off Dead)》	 Sum 41
《Still Waiting》	 Sum 41
《Fugitive》	 Tebey
《Fight Club》	 Lorne Balfe; Assassin's Creed
《偽物》	 神前暁
《Contra》	 Vomitron
《青春纪念册》	 可米小子
《River Flows in You》	 Yiruma
《夜的钢琴曲》	 K. Williams
《MAYDAY》	 TheFatRat; Laura Brehm
《Noble Companion》	 Audiomachine
《I Will Find You》	 Audiomachine
《Stronger》	 Audiomachine
《Nevertheless; She Persisted》	 Audiomachine
《无问》	 毛不易
《Cancan (Orpheus in the Underworld)》	 Herbert von Karajan; Berliner Philharmoniker
《我想》	 董昱昆
《風になる》	 つじあやの
《小幸运》	 田馥甄
《南方的我，北方的你》	 王般若
《Fleeing Kuro》	 Gareth Coker
《Light of Nibel (feat. Aeralie Brighton)》	 Gareth Coker; Aeralie Brighton
《Intro》	 The xx
《Amazing Grace》	 Judy Collins
《No Reason》	 Sum 41
《Numb Encore》	 Dr. Dre; 50 Cent; JAY-Z; Eminem; Linkin Park
《鱼玄机》	 迁梦; 洛天依
《僕は君に恋をする》	 平井堅
《君の好きなとこ》	 平井堅
《男儿当自强》	 成龙
《爱我别走》	 张震岳
《你怎么舍得我难过》	 黄品源
《童话》	 光良
《それがあなたの幸せとしても (カバー)》	 伊礼亮
《DYNAMITE GIRL》	 E-girls
《LOVE》	 E-girls
《NEVER ENDING STORY ～君に秘密を教えよう～》	 E-girls
《Pain; pain》	 E-girls
《Gotta Get Me Some》	 Nickelback
《Star Sky - Instrumental》	 Two Steps From Hell
《Take My Hand》	 Simple Plan
《Edge of a Revolution》	 Nickelback
《燕鸣骊歌(幻音宝盒版)》	 魏小涵
《幻音宝盒》	 魏小涵
《一舞倾城》	 魏小涵
《Butter-Fly (ピアノヴァージョン)》	 和田光司
《Butter-Fly》	 和田光司
《未来花》	 スキマスイッチ
《Micmacs à la gare》	 Raphaël Beau
《The Brave》	 Yosh
《追光者 英文版（Cover 岑宁儿）》	 ADÀI宋黛霆
《独孤天下》	 李玉刚
《'Resident Evil Main Title Theme (film score)》	 Marilyn Manson
《BRE@TH//LESS <a0v>》	 小林未郁
《I Want My Tears Back》	 Nightwish
《天策-天策府》	 月之门
《秦时明月-飞雪玉花》	 魏小涵
《Dragostea Din Tei》	 O-Zone
《月光》	 胡彦斌
《心中想的还是他》	 禹丁洁
《人生不过一百年》	 袁接伟
《丁建国写的歌》	 路默依
《天后（国粤版）（Cover 陈势安）》	 阿细
《Perfect Time <再arr>》	 小林未郁; mpi
《追光者（粤语版）（Cover 岑宁儿）》	 阿细
《Best of 2017 Medley》	 Anthem Lights
《The Single Life》	 Sarina Paris
《Despacito 缓缓》	 Luis Fonsi; 林俊杰
《Themes from Pirates of the Caribbean》	 The Piano Guys; Hans Zimmer
《Donde Estas; Yolanda?》	 Pink Martini
《Love Story meets Viva La Vida》	 Jon Schmidt
《南方姑娘》	 赵雷
《喜欢你》	 Beyond
《冷雨夜》	 Beyond
《真的爱你》	 Beyond
《不再犹豫》	 Beyond
《海阔天空》	 Beyond
《Butter-Fly》	 和田光司
《紅蓮の弓矢》	 Linked Horizon
《Wicked Wonderland (Radio Edit)》	 Tungevaag
《普通Disco(伴奏)》	 花僮
《君の好きなとこ》	 平井堅
《回レ! 雪月花》	 原田ひとみ; 茅野愛衣; 小倉唯
《Only My Railgun》	 fripSide
《追光者（Cover 岑宁儿）》	 伦桑
《Letter Song》	 ヲタみん
《最美不过夕阳红》	 刘秉义
《病名は愛だった》	 Neru; 鏡音リン; 鏡音レン; z'5
《追光使者》	 洛天依Official
《极乐净土》	 圈9
《Prototype》	 Jeff Lorber Fusion
《Shape of You》	 Ed Sheeran
《24K Magic》	 Bruno Mars
《墨》	 任然
《Moon River》	 Henry Mancini; 2Cellos; Johnny Mercer
《普通DISCO》	 ilem; 洛天依Official; 言和
《Come Sail Away》	 David Osborne
《都选C-乔杉版(《缝纫机乐队》电影插曲)（Cover 乔杉）》	 郑德超
《世界が終るまでは···》	 WANDS
《From Out of the Mist We Came Forth》	 Slechtvalk
《《漂洋过海来看你》-姜创钢琴版（翻自 刘明湘）》	 姜创钢琴
《追光者》	 岑宁儿
《Proud Of You》	 冯曦妤
《Larger Than Life》	 Backstreet Boys
《Beat It》	 Michael Jackson
《Toxic》	 Britney Spears
《Starships》	 Nicki Minaj
《The Nights》	 Avicii; Nicholas Furlong
《Trouble Is A Friend》	 Lenka
《Steal My Girl》	 One Direction
《TiK ToK》	 Kesha
《激昂壮志（壮絶激昂）-泠鸢翻唱（Cover 上坂堇）》	 泠鸢yousa
《三万英尺》	 迪克牛仔
《朋友别哭》	 吕方
《Rolling in the Deep》	 Adele
《Playerunknowns Battlegrounds Main Menu Theme》	 Various Artists
《空空如也》	 任然
《愿做菩萨那朵莲》	 梅朵
《Despacito》	 2Cellos
《温柔乡》	 陈雅森
《有没有人告诉你》	 陈楚生
《卷珠帘》	 周深
《秦淮八艳》	 玉璇玑
《EXEC_COSMOFLIPS/.》	 KOKIA
《Lock Me Up》	 The Cab
《秦淮八艳（翻自 玉璇玑）》	 玄觞; 玉采田; 竹桑; 凌之轩; 冥月; 妖扬; 陈一勺; 司夏
《I wonder why...》	 花澤香菜
《やくそく》	 三森すずこ; 花澤香菜
《星空と潮騒と》	 酒井亮
《真心英雄》	 杨坤; 佟大为; 郑元畅; 张杰; 朱亚文; 陈学冬
《朋友》	 周华健
《Panama》	 Matteo
《黒猫はタンゴ》	 神前暁
《飘洋过海来看你》	 李翊君
《猫になりたい》	 つじあやの
《失恋俱乐部》	 任然
《月が泣いてる》	 つじあやの
《Good Time》	 Owl City; Carly Rae Jepsen
《夢と葉桜》	 ヲタみん
《夢と葉桜》	 初音ミク; 青木月光
《外婆桥》	 洛天依Official
《哔哩哔哩耶 BILIBILI耶 幸福就在你身边》	 泠鸢yousa; 呆萌忆
《锦鲤抄》	 泠鸢yousa
《爱的供氧》	 泠鸢yousa
《泼墨漓江【茜色诗集】》	 泠鸢yousa
《我不是伟人》	 陈小春
《I Want It That Way》	 Landon Austin; Julia Sheer
《Toccata & Fugue in D Minor》	 Vanessa-Mae
《The Spirit Tree (feat. Aeralie Brighton)》	 Gareth Coker; Aeralie Brighton
《千千阙歌(英文版)》	 Various Artists
《Ghost Riders In The Sky》	 Fendermen
《新闻频道天气预报背景音乐》	 群星
《The Lonely Shepherd》	 Zamfir
《Tishri》	 Ana Alcaide
《Revolution》	 The Score
《A Gift of a Thistle (from Braveheart)》	 Catrin Finch; Erdo Groot; Julian Lloyd Webber; Pam Chowhan; Steafan Hannigan; Stefan Hannigan
《The Good; the Bad and the Ugly - Il Buono; Il Brutto; Il Cattivo (Titles)》	 Ennio Morricone
《Compass》	 Two Steps From Hell
《Ori; Lost In the Storm (feat. Aeralie Brighton)》	 Gareth Coker; Aeralie Brighton
《Despacito》	 Sam Tsui
《Buccaneer Island》	 Brand X Music
《Epiphany》	 Shire Music
《Visions》	 Acreix
《男人海洋》	 周传雄
《ハーフムーン・セレナーデ》	 河合奈保子
《A Story You Won't Believe》	 Marcin Przybyłowicz
《Stormwind(City Theme)》	 Jason Hayes; Tracy Bush; Derek Duke; Glenn Stafford
《Some Place We Called Home》	 Piotr Musial
《Honor for All - End Credits》	 Daniel Licht; Mary Elizabeth McGlynn; Jon Licht
《She Is My Sin》	 Nightwish
《如果我说》	 乐正绫
《Helmet to Helmet》	 Brand X Music
《Fire in the Hole》	 Pegboard Nerds
《Star Sky》	 Two Steps From Hell
《The Lazy Song》	 Alex Goot
《Here We Are Again》	 CAGNET; 日向大介
《Despacito》	 MADILYN; Leroy Sanchez
《MEC Loading》	 Fredrik Englund; David Tallroth; Jonas Östholm
《Diamond Eyes (Boom-Lay Boom-Lay Boom)》	 Shinedown
《灼之花》	 洛天依Official; 乐正绫
《僕らの手には何もないけど、》	 RAM WIRE
《樱花绽放时（洛天依·乐正绫合唱ver.）》	 喵九; 洛天依Official; 乐正绫
《gamestartup1》	 Valve Studio Orchestra
《新·九九八十一》	 洛天依Official; 乐正绫; Soda纯白
《Miracle》	 Shinedown
《Dangerous》	 David Garrett; Royal Philharmonic Orchestra; Franck van der Heijden
《サクラ咲ケ - 岚》	 林そよか
《夕阳之歌(Live)》	 梅艳芳
《二言目》	 斎藤千和
《友谊之光》	 Maria Cordero
《ねこみみスイッチ》	 初音ミク
《初音ミクの消失》	 初音ミク; cosMo@暴走P
《脳漿炸裂ガール》	 初音ミク; GUMI; れるりり
《Halloween 梦》	 初音ミク
《Hand in Hand》	 livetune; 初音ミク
《だんだん早くなる》	 40mP; 初音ミク
《朧月》	 初音ミク; 湊貴大
《ワールドイズマイン》	 初音ミク; ryo (supercell)
《千本桜》	 黒うさP; 初音ミク
《【鬼畜】张全蛋在接受采访时大爆粗口》	 EDM-source
《【雷军/初音】New Friend》	 OELoop; 初音ミク; 雷军
《全世界死机！！》	 OELoop; 雷军
《17版本柯南主题旋律同时播放》	 V.A.
《活着》	 郝云
《Staple Stable》	 斎藤千和
《Nyan Cat》	 daniwellP; 桃音モモ
《拯救》	 孙楠
《修炼爱情》	 林俊杰
《追梦赤子心》	 GALA
《Intro》	 Dreamtale
《猪突猛進》	 百石元
《1-800-273-8255》	 Logic; Alessia Cara; Khalid
《For The Win (Dance Remix)》	 Two Steps From Hell; Thomas Bergersen
《Remember The Name (feat. Styles Of Beyond)》	 Fort Minor; Styles of Beyond
《Tokyo Hot》	 Z3BROTHER
《Remember The Name (Instrumental)》	 Fort Minor
《南锣鼓巷》	 接个吻，开一枪; CLARE
《とある日常の背景音楽》	 神前暁
《「ありがとうございます。助かりました」》	 神前暁
《「プラチナむかつく」》	 神前暁
《しでの鳥》	 神前暁
《At The Edge》	 千坂
《Legends Never Die》	 英雄联盟; Against the Current
《刚好》	 任然
《名探偵コナン メイン・テーマ(世紀末ヴァージョン)》	 大野克夫
《名探偵コナン メイン・テーマ (業火の向日葵ヴァージョン)》	 大野克夫
《名探侦コナン メインテーマ(漆黒フルヴァージョン)》	 大野克夫
《名探偵コナン メイン・テーマ(十字路ヴァージョン)》	 大野克夫
《名探侦コナン メイン・テーマ(絶海の探侦ヴァージョン)》	 大野克夫
《名探偵コナン メイン・テーマ(暗殺者ヴァージョン)》	 大野克夫
《名探偵コナン メイン・テーマ(天国ヴァージョン)》	 大野克夫
《名探偵コナン メイン・テーマ (銀翼ヴァージョン)》	 大野克夫
《名探偵コナン メイン・テーマ(摩天楼ヴァージョン)》	 大野克夫
《名探偵コナン メイン・テーマ(鎮魂歌ヴァージョン)》	 大野克夫
《「名探偵コナン」~メインテーマ(バラード・ヴァージョン)》	 大野克夫
《白金ディスコ(「偽物語」より)》	 Melodic Taste
《恋爱サーキュレーション(“化物语”より)》	 Melodic Taste
《hero select underscore loop》	 Valve Studio Orchestra
《Pump It》	 Bond
《El ultimo indio moxicano (song from the film 'The last Mohican')》	 Alborada Del Inka
《sweets parade》	 花澤香菜
《ぼくがいる~コナンのテーマ》	 伊織
《醉赤壁》	 林俊杰
《おどるポンポコリン》	 B.B.クイーンズ
《いのちの名前 ~ジブリ・メドレー~》	 DJ SLY
《山水之间》	 许嵩
《Wrecking Ball》	 Frankmusik
《漂亮面对》	 洛天依Official
《Despacito》	 Luis Fonsi; Daddy Yankee
《别送我》	 陈鸿宇; 苏紫旭; 刘昊霖; 寒洛&鼓润
《YMCA (Original Version 1978)》	 Village People
《The Happy Troll (Griefing Theme Song)》	 D1ofaquavibe
《我要你》	 任素汐
《ハートアラモード》	 DECO*27; 初音ミク
《ありふれたせかいせいふく》	 ピノキオピー; 初音ミク
《トルコ行进曲-オワタ\(^o^)/》	 オワタP; 初音ミク
《Love is the answer(当你孤单你会想起谁)》	 Sofia Kallgren
《50 Ways to Say Goodbye》	 Train
《Thank You》	 MKTO
《Swamp Thing》	 Pegboard Nerds
《Pink Panther Theme》	 Henry Mancini
《元素周期表》	 洛天依Official
《betrayal》	 Various Artists
《On a Slow Boat to China》	 Luke Thompson
《Gentleman》	 PSY
《Nurture》	 Stephen Mark Satterthwaite
《Through The Valley》	 Ellie
《Everything I Do I Do It for You》	 Bryan Adams
《You Are Not Alone》	 Michael Jackson
《Love The Way You Lie》	 Eminem; Rihanna
《Mr.Music》	 れるりり; 巡音ルカ; 鏡音リン; 鏡音レン; 初音ミク; 歌愛ユキ; GUMI
《Scarborough Fair / Canticle》	 Simon & Garfunkel
《Beautiful World》	 Westlife
《儿子，我是你爸爸 (Demo)》	 王宝
《drop pop candy》	 Giga; 鏡音リン; 巡音ルカ
《合久必婚 (合唱)》	 陈苑淇; 李克勤
《BRE@TH//LESS》	 小林未郁
《(Everything I Do) I Do It For You (Album Version)》	 Bryan Adams
《リバーシブル・キャンペーン（Reversible·Campaign）》	 DECO*27; 初音ミク
《Rivers of Babylon》	 Boney M.
《爱后余生》	 任然
《贝加尔湖畔》	 李健
《月半小夜曲》	 李克勤
《The Virtuosos of the Metro》	 Alexey Omelchuk
《Overture (William Tell)》	 André Rieu
《Red River Valley》	 Michael Martin Murphey
《我的未来不是梦》	 张雨生
《黄昏》	 周传雄
《【雷军】全世界死机2》	 OELoop
《世界が終るまでは》	 WANDS
《Heart in a Bottle》	 Alexey Omelchuk
《Prelude – Act I (Carmen)》	 André Rieu
《In the Long Run》	 Nick Fradiani
《Hippo》	 OMFG
《光辉岁月》	 Beyond
《My Heart》	 EH!DE; Different Heaven
《Beautiful In White (Demo)》	 Shane Filan
《Born Ready》	 Zayde Wølf
《Sealed With a Kiss》	 Bobby Vinton
《Careless Whisper》	 Wham!
《Dying》	 OMFG
《网瘾青年》	 无刃妖影; 言和; 洛天依
《凉凉》	 张碧晨; 陈奕夫; 傲日其愣; 唐倩
《Speak Softly Love》	 Andy Williams
《植物醒哥与梁非凡屋顶上的决战》	 群星
《Nothing On You》	 B.o.B; Bruno Mars
《Pink Champagne》	 Nick Lopez
《Lost Love (Instrumental)》	 Lunnna; Janey杰尼
《情深意重》	 西山居游戏音乐
《天使的翅膀》	 安琥
《一些规律》	 许飞; 姚晨
《Believer》	 Imagine Dragons
《Dying In the Sun》	 The Cranberries
《趁早(2005版)》	 张宇
《月亮惹的祸》	 张宇
《男人的好》	 张宇
《King》	 Zayde Wølf
《7 Years》	 Conor Maynard
《阿卡贝拉SHAPE OF YOU（Cover ed sheeran）》	 JACK TWO; 睡PAO友
《Aladdin Medley: Arabian Nights / One Jump Ahead / A Whole New World / Friend Like Me / Prince Ali》	 Anthem Lights
《Love Yourself / Sorry / What Do You Mean? / Where Are Ü Now?》	 Anthem Lights
《Just The Way You Are ((Acoustic))》	 Anthem Lights
《Let It Go》	 Anthem Lights
《America Medley: God Bless America / God Bless the USA / America the Beautiful / Star Spangled Banner》	 Anthem Lights
《Lion King Medley: Circle of Life / I Just Can’t Wait to Be King / Hakuna Matata / Can You Feel the Love Tonight》	 Anthem Lights
《Backstreet Boys Medley》	 Anthem Lights
《Best of 2016 Medley: Stressed Out / 7 Years / Work / Treat You Better / Can't Stop the Feeling / Closer / 24k》	 Anthem Lights
《Class of 2017 Mash-Up: My Wish / I Hope You Dance / The Climb / I Lived》	 Anthem Lights
《Rather Be (Glee Cast Version)》	 Glee Cast
《Crazy Baby》	 Fantasy Prouject
《Despacito (Remix)》	 Luis Fonsi; Daddy Yankee; Justin Bieber
《Legend》	 The Score
《パズル》	 ENE
《【三畿道】我的天空（Cover 南征北战）》	 三畿道
《66CCFF》	 洛天依Official
《William Tell Overture(威廉.泰尔进行曲)-Rossini》	 欧翠峰
《Hello（3D）》	 杭立旺
《Everybody》	 OMFG
《Pancakes》	 OMFG
《Nope》	 OMFG
《Es rappelt im Karton》	 Pixie Paris
《有没有人告诉你》	 钟明秋
《白金ディスコ》	 井口裕香
《暧昧》	 薛之谦
《Scheming Weasel (faster version)》	 Kevin MacLeod
《雅俗共赏》	 许嵩
《七月上》	 Jam
《Ghost Riders In The Sky》	 Spiderbait
《New Siberia》	 Los Straitjackets
《Too Old to Die Young》	 Brother Dege
《The Good the Bad and the Ugly》	 The Atlantics
《My Soul》	 July
《Lifeline》	 Zeraphym 六翼使徒
《Silver for Monsters...》	 Marcin Przybyłowicz
《Unity》	 Chris Tilton; Jesper Kyd; Assassin's Creed
《Freedom》	 Pharrell Williams
《白玫瑰》	 陈奕迅
《达拉崩吧》	 三无MarBlue
《一代宗师》	 西山居游戏音乐
《唐门-唐家堡》	 月之门
《風になる》	 つじあやの
《The Show》	 Lenka
《外婆桥》	 泠鸢yousa
《i hate u; i love u (feat. olivia o'brien)》	 gnash; Olivia O'Brien
《Believer (Kaskade Remix)》	 Imagine Dragons; Kaskade
《The Afternoon Of Rainy day》	 柏大輔
《Greenery Rain》	 柏大輔
《A Rainy Morning ~Main Title~》	 柏大輔
《You Spin Me Round》	 Roger Sanchez; Danzel
《Mountain Journey》	 Foxtail-Grass Studio
《央视新闻频道天气预报背景音乐》	 夏小舟
《El Dorado (Dubstep Remix)》	 Two Steps From Hell; Thomas Bergersen
《He's a Pirate (Pirates of the Caribbean theme)》	 David Garrett
《太多》	 陈冠蒲
《Clsr (Aash Mehta Flip)》	 The Chainsmokers; Aash Mehta; Halsey
《凉城》	 任然
《雪山》	 西山居游戏音乐
《神经病之歌》	 洛天依Official; 言和
《虚拟游乐场》	 洛天依Official; JZN
《Man on a Mission》	 Oh The Larceny
《素颜(英文版)》	 阿摩司
《素颜》	 许嵩; 何曼婷
《Piano Beat》	 BeaTsGOy
《Radioactive》	 Imagine Dragons
《Viva La Vida》	 Coldplay
《あの頃～ジンジンバオヂュオニー～》	 whiteeeen
《Summertime》	 K-391
《Auf Und Auf Voll Lebenslust》	 Franzl Lang
《富士山下》	 陈奕迅
《おじゃま虫》	 DECO*27; 初音ミク
《Sky (Radio Edit)》	 Steerner; Martell
《Checking Things Off of a to-do List Early In the Morning》	 Lullatone
《Nothing To Fear》	 Dexter Britain
《La Boîte à Musique》	 Rhian Sheehan
《Camille; the Steel Shadow》	 Sebastien Najand; 英雄联盟
《secret base ~君がくれたもの~》	 SILENT SIREN
《星之所在(布鲁斯口琴)》	 Various Artists
《爱我中华》	 宋祖英
《理想》	 赵雷
《Love You Like the Movies》	 Anthem Lights
《Brotherhood》	 John Dreamer
《卡农 (十孔口琴版)》	 晓月老板
《River flows in you（口琴）》	 庸中小廖
《Sex Apeal [Max Farenthide Edit]》	 Bueno Clinic
《深夜书店》	 许嵩; 洛天依Official
《Shape of You》	 Ed Sheeran
《镜花水月》	 心华; 砖厂浪人; 洛天依Official; 乐正绫; 言和
《The Last of Us》	 Gustavo Santaolalla
《Arrival》	 Halo; Neil Davidge
《Minecraft》	 C418
《四重罪孽》	 洛天依Official; 言和; 乐正绫; DELA
《Unity (Instrumental)》	 TheFatRat
《Jackpot》	 TheFatRat
《Never Be Alone》	 TheFatRat
《Monody (Radio Edit)》	 TheFatRat; Laura Brehm
《Citizens》	 Alice Russell
《ツギハギスタッカート》	 nameless
《奇妙的约会》	 洪钟
《情歌王》	 古巨基
《情歌王(法语版)》	 毛晖
《V家萌妹》	 洛天依Official
《Titoli》	 Ennio Morricone
《漂洋过海来看你》	 周深
《思念是一种病(Live)》	 张震岳
《美人鱼》	 林俊杰
《独家记忆》	 陈小春
《山外小楼夜听雨》	 任然
《告白气球》	 周杰伦
《我的歌声里》	 曲婉婷
《Frontier》	 Doctor Vox
《Nevada》	 Vicetone; Cozi Zuehlsdorff
《杏花弦外雨》	 CRITTY; 司夏
《Butter-Fly (MIX)》	 和田光司
《成都》	 赵雷
《The Next Episode instrumental》	 Snoop Dog; Dr. Dre
《Adagio》	 Lara Fabian
《Merry Go》	 Kevin MacLeod
《PIXEL》	 Tokyo Machine
《Ever Felt pt. 2》	 Otis McDonald
《The Phantom》	 MUZZ; High Maintenance
《No Disrespect》	 Paradigmmm
《Cheat Codes》	 Nitro Fun
《【DOTA全明星】信仰之花，不曾凋零》	 灵梦
《Dota™ 2》	 Video Games Live; The City of Prague Philharmonic Orchestra
《The Party Troll》	 D1ofaquavibe
《东京不太热》	 封茗囧菌
《一剪梅》	 张明敏
《红日》	 李克勤
《On My Own》	 Ashes Remain
《名探偵コナン メイン・テーマ (ベイカー街ヴァージョン)》	 大野克夫
《Counting Stars》	 Simply Three
《What Makes You Beautiful》	 Marc Sean
《【洛天依原创】刹那烟火，落尽清凉》	 九御kyuugo
《勇士天下》	 洛天依Official
《Tassel》	 Cymophane
《Habanera from Carmen / La Cumparsita》	 Martynas
《Faidherbe square (instrumental)》	 ProleteR
《Classic》	 MKTO
《火星人来过》	 薛之谦
《方圆几里》	 薛之谦
《下雨了》	 薛之谦
《等我回家》	 薛之谦
《一半》	 薛之谦
《初学者》	 薛之谦
《Prelude (VIP Edit)》	 TheFatRat; JJD
《Home to Dragons》	 Jasha Klebe; Jacob Shea
《Planet Earth II Suite》	 Hans Zimmer; Jasha Klebe; Jacob Shea
《Smooth Criminal (Michael Jackson)》	 David Garrett
《I Just Wanna Run》	 Kait Weston
《Dream It Possible》	 Delacey
《Ascent》	 Teminite
《New Thang》	 Redfoo
《Pop Danthology 2012》	 DJ Daniel Kim
《Flower Dance》	 DJ Okawari
《The Right Path》	 Thomas Greenberg
《Don Coi (Instrumental)》	 Truong Quynh Anh
《[洛天依]寂火》	 XiaoNuo丶; 时空の名前; 洛天依
《fairy stage》	 K2 SOUND
《Midnight Waltz》	 Adam Hurst
《River Flows In You (Original Mix)》	 Mark Pride
《Sundial Dreams》	 Kevin Kern
《Rain of Love》	 Blazo
《canon in d》	 Brian Crain
《各自的结局》	 Days
《Nuit Silencieuse》	 Days
《毕业前夕》	 Days
《Fantaisie de Nuit Silencieuse》	 Days
《拥有》	 几米
《彩月​-​Sai​-​getsu-》	 Otokaze
《Summer》	 久石譲
《Ding Dong Song》	 Gunther & the Sunshine Girls
《Sad Angel》	 Igor Krutoy
《global visions》	 Richard Cottle
《まっしろな雪》	 水瀬ましろ
《乱世巨星》	 陈小春
《街头霸王bgm(古烈混音版)》	 Various Artists
《Brainiac Maniac》	 Laura Shigihara
《U Make Me Wanna》	 Blue
《月下》	 洛天依Official
《Three Magic》	 3L
《恋愛サーキュレーション (双声道版)》	 花澤香菜; 釘宮理恵
《Rolling in the deep》	 廖佳琳
《极乐净土x禁忌的边界线》	 一只小鹿噜噜噜
《钢琴 极乐净土》	 逻辑
《The Fox》	 小胡仙儿
《【守望先锋】屁股disco》	 布姆人
《Hey Oh (Radio Edit)》	 Tragédie
《La La Love On My Mind》	 Ann Winsborn
《Stronger》	 Inez
《玩具城》	 StudioEIM
《千年食谱颂》	 洛天依Official
《玩具塔》	 StudioEIM
《Song from a Secret Garden》	 Secret Garden
《Windfall》	 TheFatRat
《大鱼海棠 周深《大鱼》--姜创钢琴版(cover)》	 姜创钢琴
《大鱼（电影《大鱼海棠》印象曲）》	 董敏
《Victory》	 Two Steps From Hell; Merethe Soltvedt
《Saika》	 RABPIT
《大鱼 （Cover 周深）》	 双笙（陈元汐）
《Let's Go》	 Blue Stahli
《El Condor Pasa》	 Leo Rojas
《七秀-七秀坊》	 月之门
《枫林》	 月之门
《明教·明尊》	 西山居游戏音乐
《强军战歌》	 阎维文
《当兵前的那晚上》	 汤非
《天空之城（阿卡贝拉版）》	 一瓶; 池年; 雲翼星辰; 蚂爷; 墨橙; 若比; 残音; 景象; 婳烙微; 泠沚; 2酒; 油爆琵琶
《天空の城ラピュタ》	 久石譲
《天空之城(小提琴版)》	 V.A.
《AIR》	 久石譲
《Air》	 Skyvoice
《潮鳴り》	 折戸伸治
《对不起;我只是一个宅男》	 少恭
《怪物大暴走》	 三无MarBlue
《上海滩(钢琴版)》	 郑平昌
《旅立ちの序曲 ～OVERTURE:FAIRY TAIL メインテーマ～》	 高梨康治
《站起来》	 成龙; 孙楠; 莫文蔚; 韩红
《I Knew You Were Trouble》	 MADILYN
《Taylor Swift Mash-Up》	 Anthem Lights
《幹物女（Cover 洛天依）》	 萧忆情Alex
《Careless Whisper》	 Sam Levine
《恋愛サーキュレーション》	 花澤香菜
《祖国不会忘记》	 黄鹭
《祖国不会忘记》	 韩红
《美丽的神话Ⅱ》	 孙楠; 韩红
《最炫小苹果》	 凤凰传奇; 筷子兄弟
《La La Love On My Mind》	 Ann Winsborn
《【三畿道】禁忌边界线（Cover ワルキューレ）》	 三畿道
《ツギハギスタッカート》	 とあ; 初音ミク
《Blue Star》	 初音ミク; P*Light
《Sweet Devil》	 初音ミク; P*Light
《Ievan Polkka (Replica ver.)》	 初音ミク; Otomania
《Jealousy》	 弱音ハク
《风中飞散的回忆》	 洛天依Official
《βios》	 小林未郁
《水边的阿狄丽娜》	 Richard Clayderman
《I'm Gonna Getcha Good! (Red Version)》	 Shania Twain
《沸き上がる闘志》	 六三四Musashi
《My Own Paradise》	 Tobu
《NARUTO Main Theme》	 六三四Musashi
《Hero》	 Mariah Carey
《我的天坑》	 南征北战NZBZ
《Senbonzakura》	 Lindsey Stirling
《寂寞沙洲冷》	 周传雄
《贝多芬的悲伤》	 萧风
《Beyond The Veil》	 Lindsey Stirling
《Mission Impossible》	 David Garrett
《String Tek》	 X-Ray Dog
《We Will Rock You》	 David Garrett
《Canon Rock》	 ARIA ASIA
《Take Flight》	 Lindsey Stirling
《Requiem For A Tower》	 Escala
《Palladio》	 Escala
《Contradanza》	 Vanessa-Mae
《Assassin's Creed》	 Eklipse
《Explosive》	 Bond
《Rainy Day》	 Diana Boncheva
《My Heart Will Go on (From "Titanic")》	 Taylor Davis
《Walk This Way》	 Orianthi
《Hungarian Dance No.5》	 David Garrett
《Master Of Tides》	 Lindsey Stirling
《Zi-Zi's Journey》	 Lindsey Stirling
《Dance With Dragons》	 BrunuhVille
《Viva La Vida》	 David Garrett
《Because of You》	 Josh Vietti
《Peer Gynt》	 David Garrett
《Where Is the Love》	 Josh Vietti
《Song of the Caged Bird》	 Lindsey Stirling
《IF YOU》	 韩红
《Misery》	 Maroon 5
《Save Rock And Roll》	 Fall Out Boy; Elton John
《Hymn For The Weekend（Remix）》	 Alan Walker; Coldplay
《Nova》	 Nigel Good
《Transcendence》	 Lindsey Stirling
《Arcade Ahri》	 英雄联盟
《Tales of Neverland（inspiring)》	 J.T.Peterson
《雪》	 杜婧荧; 王艺翔
《地球防御本部》	 StudioEIM
《明珠港》	 StudioEIM
《O Susanna/Camptown Races (Country Mountain Melodies Album Version)》	 Craig Duncan
《AM》	 Silencyde
《Worth It》	 Fifth Harmony; Kid Ink
《Irresistible》	 Fall Out Boy; Demi Lovato
《Uma Thurman》	 Fall Out Boy
《My Songs Know What You Did In The Dark (Light Em Up)》	 Fall Out Boy
《Piano Concerto No.1 In B Flat Minor; Op.23; TH.55:1. Allegro non troppo e molto maestoso - Allegro con spirito》	 Oregon Symphony; James DePriest
《Radetzky March Op. 228 (2005 Digital Remaster)》	 Herbert von Karajan
《Menuet D major》	 Wolfgang Amadeus Mozart
《Första Satsen Ur Symfoni Nr 5 Ödessymfonin》	 Richard Edlinger; Zagrebs Filharmoniska Orkester
《阿玛蒂斯:G大调第13号小夜曲/莫扎特》	 Wolfgang Amadeus Mozart
《The Four Seasons; Violin Concerto in E Major; RV 269 "Spring":I. Allegro》	 David Parry; Pieter Schoeman; London Philharmonic Orchestra
《Schwanengesang; D.957 (Cycle):Serenade (Ständchen D 957/4)》	 Gil Shaham; Göran Söllscher
《VI. Waltz 2 from Jazz Suite No. 2 (Eyes Wide Shut)》	 Dmitri Shostakovich
《The Godfather: Main Theme》	 André Rieu
《Trio In E-Flat; Op. 100 (Excerpt)》	 Franz Schubert
《The Four Seasons (Spring):1. Allegro》	 Antonio Vivaldi
《Michael Meets Mozart - 1 Piano; 2 Guys; 100 Cello Tracks》	 Jon Schmidt; Steven Sharp Nelson
《维也纳森林圆舞曲》	 Johann Strauss II
《Gavotte in D major;Rosine(arr. for violin and piano)》	 Linda Rosenthal
《Symphony No. 5 in C Minor; Op. 67:I. Allegro con brio》	 Herbert von Karajan; Berliner Philharmoniker
《蓝色多瑙河圆舞曲》	 Johann Strauss II
《La Valse D'amelie》	 Yann Tiersen
《River Flows In You》	 Martin Ermen
《梦中的婚礼》	 Richard Clayderman
《天国と地狱》	 Jacques Offenbach; 泉陸奥彦
《未闻花名 (口琴版)》	 V.A.
《Forrest Gump Suite》	 Alan Silvestri
《赫顿玛尔(ACT.8-大转移前) - hendonmyre new》	 Dungeon and Fighter
《Title Theme》	 Ari Pulkkinen
《Ekko;the Boy Who Shattered Time》	 Sebastien Najand; 英雄联盟
《Yankee Doodle/Battle Cry Of Freedom》	 Craig Duncan
《Entertainer; The》	 Paralyzed Veterans of America
《Last Reunion》	 EpicMusicVn
《Free Loop》	 Daniel Powter
《8 Humoresques; Op. 101; B. 187:No. 7; Poco lento e grazioso (Transcribed by Oscar Morawetz for Violin; Cello & Orchestra)》	 Seiji Ozawa; 马友友; Itzhak Perlman; Boston Symphony Orchestra
《outside sandwiches》	 Lullatone
《Classico》	 Tenacious D
《いけないボーダーライン》	 ワルキューレ
《Pneumatic Tokyo》	 EnV
《登录界面音乐(大转移前) - character select stage》	 Dungeon and Fighter
《Wild Side》	 Danny Olson; Kimberly Cole
《Hungarian Dance》	 Johannes Brahms
《Yankee Doodle》	 Paralyzed Veterans of America
《Freedom Is Ours》	 Epic Score
《Finally Free》	 Kari Kimmel
《Schnappi》	 Joy Gruttmann
《House of Cards》	 Tyler Shaw
《Spring In My Step》	 Silent Partner
《Axel F》	 Crazy Frog
《地上BGM》	 近藤浩治
《ポケットモンスター 赤・緑：メインテーマ［64］》	 安藤浩和
《我的舞台》	 灵感; 胡彦斌
《让我们荡起双桨》	 中央人民广播电台少年广播合唱团
《马丁的早晨主题曲》	 群星
《Universal Fanfare》	 The Minions
《As Long as We Got Each Other》	 Dusty Springfield; B.J. Thomas
《Touche; Pussy Cat!* (1954; Tom and Jerry)》	 Scott Bradley
《上海滩》	 叶丽仪
《铁血丹心》	 罗文; 甄妮
《1997-1998_M20》	 宮崎慎二
《Theme From Superman》	 John Williams
《William Tell: Overture (Finale) [Lone Ranger Theme]》	 Cincinnati Pops Orchestra; Erich Kunzel
《Just Blue》	 Space
《Spectre》	 Alan Walker
《Like Me; OK?》	 雷军; Lemon
《Braum》	 英雄联盟
《Freljord》	 英雄联盟
《바람의 너를》	 Lu Sienna
《Return of the Ancients》	 Glenn Stafford; Derek Duke; Tracy Bush
《いのちの名前》	 泠鸢yousa
《The Benny Hill Show ("Yakety Sax")》	 Boots Randolph
《Who Let The Dogs Out》	 Baha Men
《I Will Return》	 Skylar Grey
《Lemon Tree》	 Fool's Garden
《The Next Episode》	 Dr. Dre; Snoop Dogg; Nate Dogg
《Oh Father》	 Bodhi Jones
《ID》	 Panda Eyes; Phantom Sage
《Heart Like California》	 Before You Exit
《Nobody Compares》	 One Direction
《Chasing The Wind》	 Josiah James
《2 Soon》	 Jon Young
《The Man Who Can't Be Moved》	 The Script
《If You Could See Me Now》	 The Script
《Time Bomb》	 Feint; Boyinaband; Veela
《Jelly》	 OMFG
《DotA (Radio Edit)》	 Basshunter
《Floorfiller》	 A*Teens
《Blank Space》	 Taylor Swift
《Out Of The Woods》	 Taylor Swift
《I Wish You Would》	 Taylor Swift
《Bad Blood》	 Taylor Swift
《Wildest Dreams》	 Taylor Swift
《How You Get The Girl》	 Taylor Swift
《This Love》	 Taylor Swift
《I Know Places》	 Taylor Swift
《Clean》	 Taylor Swift
《You Are In Love》	 Taylor Swift
《New Romantics》	 Taylor Swift
《I Know Places (Voice Memo)》	 Taylor Swift
《I Wish You Would (Voice Memo)》	 Taylor Swift
《Blank Space (Voice Memo)》	 Taylor Swift
《Wonderland》	 Taylor Swift
《All You Had To Do Was Stay》	 Taylor Swift
《Style》	 Taylor Swift
《Welcome To New York》	 Taylor Swift
《Best of 2014: Problem / Boom Clap / Rude / Am I Wrong / All About That Bass / All of Me / Chandelier / Blank Space / Not a Bad Thing / Happy》	 Anthem Lights
《Best of 2013 Mash-Up》	 Anthem Lights
《What Do You Mean?》	 Justin Bieber
《Never Say Never》	 The Fray
《Cornfield Chase》	 Hans Zimmer
《我们不该这样的》	 张赫煊
《Tales of the Electric Romeo》	 Immediate
《Reverse   Parallel Universe》	 V.K克
《千本桜》	 茶理理
《Two Rogues; One Mark》	 Peter McConnell
《Best of 2012: Payphone/Call Me Maybe/Wide Awake/Starship/We Are Young》	 Anthem Lights
《傲气傲笑万重浪》	 黄霑
《摩诃不思议アドベンチャー!(TV ver.)》	 高橋洋樹
《What Are You Waiting For?》	 Nickelback
《Pull up a Chair》	 Peter McConnell
《Here Comes Vi》	 英雄联盟
《I Am You》	 Kim Taylor
《Me and My Broken Heart》	 Push Baby
《快点告诉你》	 苑冉
《Butter-Fly -tri.Version-》	 和田光司
《蘭のテーマ》	 大野克夫
《brave heart -tri.Version-》	 宮崎歩
《こなたのテーマ、沖縄バージョン》	 神前暁
《We No Speak Americano(UK Radio Edit)》	 Yolanda Be Cool
《Hypnotic》	 Zella Day
《Best of 2015: Style / What Do You Mean / Uptown Funk / Love Me Like You Do / Watch Me / See You Again》	 Anthem Lights
《Journey》	 Capo Productions
《水面の満月》	 神乃木製作所
《Epic Sax Guy》	 Sunstroke Project
《大鱼钢琴版》	 昼夜
《Mi Mi Mi》	 Serebro
《花火》	 清浦夏実
《Jhin; the Virtuoso》	 Edouard Brenneisen; 英雄联盟
《Ethereal》	 英雄联盟; Nosaj Thing; Pretty Lights
《DJ SONA - DJ Sona Kinetic(自由页 Remix)（自由页 remix）》	 自由页
《Adventure Time》	 Philter
《Rage your dream》	 m.o.v.e
《Immortals (End Credit Version) ["From "Big Hero 6”]》	 Fall Out Boy
《Can't Stop Love》	 Darin
《Just the Way You Are》	 Bruno Mars
《Let Her Go》	 Jasmine Thompson
《midnightride》	 Various Artists
《What If (Bonus track)》	 Darin
《白いスーツのテーマ》	 市川淳
《Häschenparty (Album Version)》	 Schnuffel
《Chain Hang Low》	 Jibbs
《美しきもの》	 Sound Horizon
《The Hampster Dance Song》	 Hampton the Hampster
《Take Me Hand》	 DAISHI DANCE; Cécile Corbel
《I Just Wanna Run》	 The Downtown Fiction
《What Are Words》	 Chris Medina
《用心良苦》	 张宇
《This Is The Summer》	 Solid Base
《The Monster》	 Eminem; Rihanna
《BUCKLE UP N CHUGGELUCK HEAVEN》	 Cecil Jonni Lauro
《Loves Me Not》	 t.A.T.u.
《TEMPTATION》	 Arash
《流川枫与苍井空》	 黑撒
《Aankhen Khuli》	 Shahrukh Khan
《Here Comes the Hotstepper (Yuksek Remix)》	 Baby & Me
《贫民百万歌星伴奏》	 MC HotDog 热狗
《The Phoenix》	 Fall Out Boy
《Liberators》	 Epic Score
《Go Time》	 Mark Petrie
《小鸡哔哔》	 洛天依Official
《Higher》	 Tobu
《Aggressive Michael》	 The Diner
《Cloud 9》	 Tobu; Itro
《Bad Apple!!(东方幻想郷)》	 TAMUSIC
《Bad Apple!!》	 のみこ
《不如不见》	 陈奕迅
《Rally the Heroes》	 Derek Duke
《Victory》	 Derek Duke; Neal Acree
《levan Polkka》	 Loituma
《Ce Frumoasa E Iubirea》	 Giulia
《The Last Mohican》	 Alborada Del Inka
《Soldier》	 Samantha Jade
《Forgettable》	 Project 46; Olivia
《Saika》	 RABPIT
《Miku》	 初音ミク; Anamanaguchi
《故郷の原风景》	 宗次郎
《万里の長城》	 太田美知彦
《アフロディーテ》	 S.E.N.S.
《我的滑板鞋》	 张全蛋
《我的滑板鞋》	 约瑟翰庞麦郎
《模特 (Live)》	 李荣浩
《我好像在哪见过你》	 薛之谦
《The truth that you leave》	 Pianoboy高至豪
《Masked Heroes》	 Vexento
《杀手》	 林俊杰
《Hakuna Matata (From "The Lion King"/Soundtrack)》	 Joseph Williams; Jason Weaver; Ernie Sabella; Nathan Lane
《Demons》	 Imagine Dragons
《Hall of Fame》	 The Script; will.i.am
《Almost Lover》	 A Fine Frenzy
《Till the World Ends》	 Britney Spears
《认真的雪》	 薛之谦
《The Beginning》	 Ryan
《Stronger》	 Kelly Clarkson
《ninelie》	 Aimer; EGOIST
《Highland》	 Canvai
《名探偵コナン メイン・テーマ(戦慄ヴァージョン)》	 大野克夫
《X Gon' Give It to Ya (Radio Edit)》	 DMX
《可惜不是你》	 曹轩宾
《时间煮雨》	 郁可唯
《丑八怪》	 薛之谦
《匆匆那年》	 二珂
《小城谣（Cover 胡碧乔）》	 泥鳅Niko
《绅士》	 薛之谦
《演员》	 薛之谦
《刚刚好》	 薛之谦
《Love Me Like You Do》	 Ellie Goulding
《Sing Me to Sleep (Instrumental)》	 Alan Walker
《Sing Me to Sleep》	 Alan Walker; Iselin Solheim
《Unity》	 Axero
《当三国杀遇上nobody》	 翼侯大人
《当红警遇上Nobody》	 Various Artists
《The Fox (What Does the Fox Say?)》	 Ylvis
《The New Earth》	 Audiomachine
《300 Violin Orchestra》	 Jorge Quintero
《Sad Run》	 V.A.
《Legions of Doom》	 Audiomachine
《An Unfinished Life》	 Audiomachine
《Man At Arms》	 Position Music
《League of Legends Epic Dubstep(LOL Remix)》	 ThimLife
《Electric Romeo》	 Immediate Music
《Stitches》	 Shawn Mendes
《单身情歌》	 林志炫
《眉间雪》	 HITA
《湖心亭（纯歌版）》	 小曲儿; 蔡翊昇
《你还要我怎样》	 薛之谦
《一吻之间》	 张碧晨
《Madona》	 Era
《Ameno》	 Era
《The Mass》	 Era
《Divano》	 Era
《We Are Young》	 Mike Tompkins
《See You Again》	 Mike Tompkins
《Rolling In The Deep》	 Mike Tompkins
《Sugar》	 Mike Tompkins
《Faded》	 Alan Walker
《Ascension (Remix)》	 MitiS; Dope Arcade
《Lucky Strike》	 Maroon 5
《She Will Be Loved》	 Maroon 5
《Won't Go Home Without You》	 Maroon 5
《Voodoo People》	 Pendulum
《brave heart》	 宮崎歩
《Beautiful Lies》	 B-Complex
《Beyond The Game》	 a l o u t
《Alone Together》	 Fall Out Boy
《Centuries》	 Fall Out Boy
《Pump It》	 Black Eyed Peas
《我的洗发液》	 成龙
《卧槽大爷歌》	 群星
《R U OK (Chinglish ver.)》	 雷军
《好汉歌英文版》	 群星
《打dota的变态》	 冷面EATTTTT
《如果我搞比利你会爱我吗 (英文版)》	 A路人
《aHUOz》	 Bi哩Bi哩汪
《千本桜(古筝版)》	 墨韵
《我是全英雄联盟最骚的骚猪》	 PDD
《Magic》	 Tobu; Itro
《御剑江湖》	 骆集益
《Superheroes》	 The Script
《我的天空》	 南征北战NZBZ
《Focus》	 Ariana Grande
《CHIKI CHIKI》	 Starclub
《CALL FROM BABYLON》	 Blue Lagoon
《CE FRUMOASA E IUBIREA》	 Giulia
《DOAR CU TINE》	 Activ
《Can You Feel It》	 Jean Roch
《江南(粤语版)》	 林俊杰
《One More Night》	 Maroon 5
《Maps》	 Maroon 5
《My Heart Is Open》	 Maroon 5; Gwen Stefani
《Just A Feeling》	 Maroon 5
《欢迎进行曲》	 中国人民解放军军乐团
《运动员进行曲》	 中国人民解放军军乐团
《死机之歌》	 Dj Titon
《This Summer (Maroon 5 vs. Alesso)》	 Maroon 5; Alesso
《Feelings》	 Maroon 5
《Payphone》	 Maroon 5; Wiz Khalifa
《Moves Like Jagger》	 Maroon 5; Christina Aguilera
《Animals》	 Maroon 5
《Nara (Theme to Cold Case)》	 E.S. Posthumus
《Falling Into a Dream》	 Brian Tyler
《Take Me To Your Heart》	 Michael Learns To Rock
《21 Guns》	 Green Day
《You Raise Me Up》	 Westlife
《Shape Of My Heart》	 Sting
《天空之城 (800人合唱版)》	 V.A.
《天空之城(吟唱版)》	 小娟&山谷里的居民
《Five Hundred Miles》	 Justin Timberlake; Carey Mulligan; Stark Sands
《If I Die Young (originally by The Band Perry)》	 Sam Tsui
《Summer Vibe》	 Walk off the Earth
《OneRepublic Mash-Up》	 Anthem Lights
《Wings Of Piano》	 V.K克
《China Loading》	 Fredrik Englund; David Tallroth; Jonas Östholm
《Lead Me Home》	 Jamie N Commons
《当你老了》	 赵照
《The Last of the Mohicans (街头艺人演奏版)》	 Alexandro Querevalú
《Let Down (feat. Andrew Harris)》	 Axero; Andrew Harris
《Candyman》	 Zedd; Aloe Blacc
《天空之城》	 张信哲
《拉德斯基进行曲》	 Herbert von Karajan
《春节序曲》	 中国人民解放军军乐团
《红玫瑰(国)》	 陈奕迅
《Levels (Radio Edit)》	 Avicii
《One Call Away》	 Charlie Puth
《See You Again (Piano Demo Version)》	 Charlie Puth
《Look At Me Now》	 Charlie Puth
《稻香村》	 月之门
《纯阳宫1》	 月之门
《残酷な天使のテーゼ》	 高橋洋子
《「名探偵コナン」~メインテーマ》	 大野克夫
《キミがいれば》	 伊織
《白桦林》	 朴树
《Vivid》	 Valcos
《EuroDancer》	 Klave
《光荣啊，中国共青团》	 群星
《月光酒馆 - tavern》	 Dungeon and Fighter
《바람의 너를 (inst.)》	 Lu Sienna
《Quazar (8-bit/chiptune)  Funky Stars (Hybrid song)》	 Various Artists
《Butter-Fly》	 和田光司
《Zombies on Your Lawn》	 Laura Shigihara
《Be What You Wanna Be》	 Darin
《Supermassive Black Hole (Twilight Soundtrack Version)》	 Muse
《Born a Champion》	 Network Music Ensemble
《Palace Memories》	 S.E.N.S.
《Pacific Rim (feat. Tom Morello)》	 Ramin Djawadi; Tom Morello
《冒险岛登录》	 群星
《Warriors》	 Imagine Dragons
《Beethoven Virus》	 Diana Boncheva
《Energy Drink》	 Virtual Riot
《attraction》	 小澤正澄
《Battle Without Honor Or Humanity》	 布袋寅泰
《Sugar》	 Maroon 5
《Lovin' You ('06 Version)》	 Shanice
《Welcome to Planet Urf》	 英雄联盟
《Silver Scrapes》	 英雄联盟; Danny McCarthy
《Worlds Collide》	 英雄联盟; Nicki Taylor
《Bangarang》	 Skrillex; Sirah
《Seve》	 Tez Cadey
《大河之舞》	 群星
《Lion's Pride》	 Jason Hayes
《The Day You Went Away》	 M2M
《Burning》	 Maria Arredondo
《Breaking The Habit》	 Linkin Park
《What I've Done》	 Linkin Park
《New Divide》	 Linkin Park
《Faint》	 Linkin Park
《In the End》	 Linkin Park
《Numb》	 Linkin Park
《好久不见》	 陈奕迅
《Butterfly》	 Smile. DK
《晴天》	 周杰伦
《Fallen Angel》	 Backstreet Boys
《Show Me the Meaning of Being Lonely》	 Backstreet Boys
《I Want It That Way》	 Backstreet Boys
《As Long as You Love Me》	 Backstreet Boys
《千本桜 (Game Version)》	 初音ミク; 黒うさP
《炉心融解》	 iroha(sasaki); kuma; 鏡音リン
《甩葱歌》	 初XX来
《夜空中最亮的星(法语版)》	 毛晖; 周磊
《夜空中最亮的星》	 逃跑计划
《我是不是你最疼爱的人》	 赵已然
《别怕我伤心》	 张信哲
《Wonderful》	 OMFG
《卡农》	 V.A.
《美国巡逻兵进行曲》	 Various Artists
《Blessing(World Edition)》	 チューン; Sumashu; MASTAH; Kiro; 茶理理; 蓮; Ehmz; Un3h; ENAE; CheeseMan; Paperblossom; 鳥子; Howl
《TEENAGE LIFE》	 Daz Sampson
《WHY DONT YOU PLAY LOUDER》	 Rimini Project
《SARVAR》	 ABV
《Oops J'Aime Pas L'Anglais !》	 Gullia
《贝多芬第8号钢琴奏鸣曲悲伤的第三乐章》	 Various Artists
《克罗地亚第二狂想曲》	 Various Artists
《Linkin Park Mashup》	 MetroGnome
《Mashed Potatoes》	 OMFG
《超级玛丽二胡版》	 Various Artists
《Stop Crying Your Heart Out》	 Oasis
《Theme from Mission: Impossible》	 Danny Elfman
《Cyberworld》	 X-Ray Dog
《Mission Impossible (Main Theme) - Main Theme》	 Maksim Mrvica
《Cubana Cubana》	 Maksim Mrvica
《Victory Remix》	 Maksim Mrvica
《Croatian Rhapsody》	 Maksim Mrvica
《Ringtone (MetroGnome Remix)》	 MetroGnome
《无敌》	 邓超
《Boom Clap》	 Charli xcx
《GDFR (feat. Sage the Gemini & Lookas)》	 Flo Rida; Sage the Gemini; Lookas
《aLIEz》	 瑞葵(mizuki); SawanoHiroyuki[nZk]
《New York》	 群星
《Ok》	 OMFG
《Ice Cream》	 OMFG
《I Love You》	 OMFG; MILLAN
《Yeah》	 OMFG
《Davy Jones》	 Hans Zimmer
《One Day》	 Hans Zimmer
《Pirates Of The Caribbean (He's A Pirate)》	 Maksim Mrvica
《Take Me Home Country Roads》	 V.A.
《梦中的婚礼(八音盒完整版)》	 群星
《Moonlight Flight (My Neighbor Totoro)》	 V.A.
《Main Title - Setsuko & Seita (Grave of the Firefies)》	 V.A.
《The Legend of Ashitaka (Princess Mononoke)》	 V.A.
《Name of Life (Spirited Away)》	 V.A.
《天空之城》	 V.A.
《鸟之诗 (八音盒版)》	 折戸伸治
《He's a Pirate》	 Klaus Badelt
《Hoist The Colours》	 Hans Zimmer
《Always Getting Over You》	 Angela Ammons
《Get Jinxed》	 Agnete Kjolsund
《Yesterday Once More》	 Carpenters
《Boulevard Of Broken Dreams》	 Green Day
《平凡之路 + See You Again (Live)》	 张信哲
《龙之梦境》	 StudioEIM
《夏恋》	 Otokaze
《Nobody(Eng ver.)》	 Wonder Girls
《叶问》	 王蓉; 老猫; 杨宗南
《Despicable Me》	 Pharrell Williams
《Happy》	 Pharrell Williams
《Y.M.C.A.》	 The Minions
《Faraway》	 Gala
《情动》	 YEHAIYAHAN
《GALAXY SUPERNOVA》	 少女时代
《Hey Mama (The Blueprint)》	 Alexander The Phatos
《不再联系》	 夏天Alex
《Love Runs Out》	 OneRepublic
《See You Again》	 Wiz Khalifa; Charlie Puth
《浮夸》	 陈奕迅
《最佳损友》	 陈奕迅
《Dragostea Din Tei (Original Romanian Version)》	 O-Zone
《Tidecaller》	 英雄联盟
《All We Are》	 OneRepublic
《Give Your Heart A Break》	 Demi Lovato
《暗涌》	 王菲
《Heaven's Devils》	 Glenn Stafford
《Hello》	 OMFG
《Time Bomb》	 Boyinaband; Feint; Veela
《Breath and Life》	 Audiomachine
《Hello》	 Adele
《Halo》	 Beyoncé
《但愿人长久》	 邓丽君
《月亮代表我的心》	 邓丽君
《小城故事》	 邓丽君
《Main Titles》	 Ramin Djawadi
《Kung Fu Fighting》	 Cee-Lo Green; Jack Black
《Saika》	 RABPIT
《Hua Sui Yue》	 V.K克
《信仰 (Live)》	 张信哲
《再见...警察》	 陈光荣
《You Know My Name》	 Chris Cornell
《男儿当自强 (狮王争霸之大合唱)》	 Tam Sik Hay; Donald Cheung
《Not Afraid》	 Eminem
《Kinetic》	 英雄联盟; The Crystal Method; Dada Life
《Guardians at the Gate》	 Audiomachine
《Elektrik (Sonixtended)》	 Flying Steps
《明教·梵影》	 西山居游戏音乐
《TiK ToK》	 Kesha
《Glimmer》	 祈Inory
《We Are Electric》	 Flying Steps
《Beach Party》	 Gabriel Heinrich Grote
《Uptown Funk》	 Mark Ronson; Bruno Mars
《Cytus》	 Sta
《Scarborough Fair》	 Sarah Brightman
《I Believe I Can Fly》	 R. Kelly
《Here I Am》	 Bryan Adams
《Scarborough Fair》	 In Tune
《My Heart Will Go On (Love Theme from "Titanic")》	 Céline Dion
《同一首歌》	 蔡国庆
《It's My Life》	 Bon Jovi
《One bad man》	 Midnight Riders
《Champion Select (Draft Pick Normal Mode)》	 Daniel Vulcano; Duncan Watt; 英雄联盟
《Summoning Glory》	 英雄联盟
《Firefly》	 Jim Yosef
《Concussive》	 英雄联盟; Bassnectar; Renholder
《Waka Waka (This Time for Africa)》	 Shakira; Freshlyground
《Runaway》	 Groove Coverage
《On the Radio》	 Groove Coverage
《God Is a Girl》	 Groove Coverage
《Far Away From Home》	 Groove Coverage
《甜蜜蜜》	 邓丽君
《Nothing's Gonna Change My Love For You》	 Westlife
《Teenage Dream》	 Katy Perry
《Fade》	 Alan Walker
《Secrets》	 OneRepublic
《Apologize》	 OneRepublic
《好久不见(国)》	 陈奕迅
《爱情转移(国)》	 陈奕迅
《匆匆那年》	 王菲
《One Day》	 Matisyahu
《What Makes You Beautiful》	 One Direction
《We Are Young (feat. Janelle Monáe)》	 Fun.; Janelle Monáe
《Let It Go》	 Demi Lovato
《Boom Boom Pow (Clean)》	 Black Eyed Peas
《We Own It (feat. Wiz Khalifa)》	 2 Chainz
《Counting Stars》	 OneRepublic
《Marvin Gaye (feat. Meghan Trainor)》	 Charlie Puth; Meghan Trainor
《空白格 (Live)》	 杨宗纬
《一剪梅》	 费玉清